111111111111111
100010000000001
111010111111101
100010100000001
101111101111111
100010001000001
111010111011101
101010000010001
101011111110101
101000001000101
101111101011101
101000001010001
101011111010111
100000000010001
111111111111111
