111111111111111
101000000000001
101111111110111
101000000010001
101011111011101
100010001000101
111110101110101
100010100010001
101010111111101
101000100000101
101111101011101
101000101000101
101010101110101
100010000010001
111111111111111
